SO ./assets/kiro_64x64.xpm
C 0,0,0 
WE ./assets/kiro_64x64.xpm

F 0,0,0

NO ./assets/kiro_64x64.xpm



EA ./assets/kiro_64x64.xpm

1111111111111111111111111
1000000000110000000000001111111111111111111111
101100000111000000W000000000000000000000000001
1001000000000000000000001111111111111111111111
1111111110110000011100001111111
100000000011000001110111111111111
11110111111111011100000011111
1111011111111101110101001
110000001101010111000000111111
1000000000000000110000001000011111
1000000000000000110101000000110001
1100000111010101111101000000000001
11110111 1110101 10111100000100001
11111111 1111111 11111111111111111