NO ./assets/matrix_64x64.xpm
EA ./assets/matrix_64x64.xpm
SO ./assets/matrix_64x64.xpm
WE ./assets/matrix_64x64.xpm

F 0,0,0
C 0,0,0

1111111111111111111111111
1000000000000000000000011111111111
1E00000000000000000000000000000001
1000000000000011111111111111111111
10000110101000000110001
10101111111000011100001
11111111 1110101 101111
11110111 1110101 101111
11111111 1111111 111111